1 1 1 1 1 1 1 1 1 1
1 2 4 0 0 0 4 3 0 1
1 2 0 0 4 4 4 0 2 1
0 0 2 4 2 0 0 4 0 0
1 0 4 0 0 3 0 3 3 1
1 2 3 0 3 4 3 0 0 1
1 1 1 1 1 1 1 1 1 1
